NO textures/NO.png
SO textures/SO.png
WE textures/WE.png
EA textures/EA.png
F 220,100,0
C 225,30,0
111111111111111111111111111111
100000000011000000000000000001
101100000111000000000000000001
100100000000000000000000000001
111111111011000001110000000001
100000000011000001110000000001
111101111111110111000000000001
111101111111110111010100000001
110000001101010111000000000001
100000000000000011000000000001
100000000000000011010100000001
110000011101010111110111100001
111101111111010111011111100001
100000000011000000000000000001
100000000011000000000000000001
100000000001000010000100000001
100000001101010111000000000001
1000000011010101110000000N0001
100000000000000011010100000001
111111111111111111111111111111