NO textures/NO.png
SO textures/SO.png
WE textures/WE.png
EA textures/EA.png
F 0,0,0
C 50,50,255

11111111111111111111
10000001000000000001
10000000000000000001
10000000000000000001
10000000000000000001
10000000000000000001
10000001000000000001
10000000000000000101
10000000000000000001
10000000000000000001
100010000000000001N1
11111111111111111111


